[Textures]
Tiles\GreyBlock
Tiles\BlueBlock
Tiles\RedBlock

[Layout]
1 1 1 1 1 1 1 1 1 1 1 1 
1 0 0 0 0 0 0 0 0 0 0 1 
1 0 5 0 0 0 0 0 1 0 0 1 
1 0 0 0 0 0 0 0 0 0 1 1 
1 0 0 0 0 0 5 0 0 0 0 1 
1 1 3 0 0 0 0 0 0 0 0 1 
1 0 0 1 0 0 1 0 1 0 0 1 
1 5 0 0 0 0 0 0 0 0 0 1 
1 0 0 0 9 1 8 0 0 0 0 1 
1 4 0 0 0 0 0 0 0 0 0 1 
1 0 0 1 0 0 0 0 3 2 0 1 
1 1 2 0 0 0 4 2 0 0 0 1 
1 0 0 0 0 0 0 0 0 0 0 1 
1 0 1 0 0 0 0 0 0 0 0 1 
1 0 1 0 0 0 0 0 0 0 0 1 
1 0 0 0 0 1 0 0 0 0 0 1 
1 0 0 0 0 1 0 0 0 0 0 1 
1 1 1 1 1 1 1 1 1 1 1 1

[Fuel]
20