[Textures]
Tiles\GreyBlock
Tiles\BlueBlock
Tiles\RedBlock

[Layout]
1 1 1 1 1 1 1 1 1 1 1 1 
1 1 0 0 1 1 0 0 0 0 0 1 
1 1 0 0 0 1 0 0 0 0 0 1 
1 1 0 0 0 0 0 0 0 3 3 1 
1 0 0 1 0 0 0 0 0 0 0 1 
1 0 0 0 0 0 2 0 0 0 0 1 
1 0 0 0 0 0 2 0 0 0 0 1 
1 0 0 0 0 0 0 0 3 0 0 1 
1 0 1 0 0 0 0 0 0 0 0 1 
1 0 0 0 1 5 0 0 0 0 0 1 
1 1 0 0 5 0 0 1 1 0 0 1 
1 0 0 0 0 0 0 0 0 0 0 1 
1 0 0 0 0 0 0 0 0 0 0 1 
1 1 0 3 0 0 9 0 3 3 2 1 
1 0 0 0 0 0 1 0 0 0 8 1 
1 0 0 0 0 0 0 0 0 0 0 1 
1 1 0 0 0 0 0 0 1 1 1 1 
1 1 1 1 1 1 1 1 1 1 1 1

[Fuel]
12