[Textures]
Tiles\GreyBlock
Tiles\BlueBlock
Tiles\RedBlock

[Layout]
1 1 1 1 1 1 1 1 1 1 1 1 
1 5 0 0 0 0 0 0 1 0 5 1 
1 1 0 0 0 0 0 0 1 0 1 1 
1 0 0 0 0 0 0 0 0 0 0 1 
1 0 0 0 0 0 9 0 0 0 0 1 
1 0 0 1 0 1 0 0 1 0 0 1 
1 1 0 0 0 0 0 0 0 0 1 1 
1 0 0 0 0 0 4 0 0 0 0 1 
1 0 0 0 0 0 4 0 0 0 0 1 
1 0 0 0 0 0 4 0 0 0 0 1 
1 0 0 0 0 0 0 0 0 0 0 1 
1 0 0 3 0 0 0 0 1 0 0 1 
1 0 0 0 0 0 3 0 0 0 0 1 
1 1 2 3 1 0 0 0 0 3 0 1 
1 1 0 0 0 1 0 0 0 1 0 1 
1 0 0 0 0 0 1 1 1 1 1 1 
1 8 0 0 0 0 1 0 0 0 0 1 
1 1 1 1 1 1 1 1 1 1 1 1

[Fuel]
13