[Textures]
Tiles\GreyBlock
Tiles\BlueBlock
Tiles\RedBlock

[Layout]
1 1 1 1 1 1 1 1 1 1 1 1 
1 0 0 1 0 0 0 5 1 0 0 1 
1 0 0 0 0 0 0 0 1 0 1 1 
1 0 0 9 4 5 4 0 3 0 0 1 
1 1 0 0 0 0 0 0 0 0 0 1 
1 0 0 0 0 0 0 0 0 0 0 1 
1 0 3 0 0 0 0 2 1 1 1 1 
1 0 0 0 0 0 0 0 0 0 1 1 
1 0 0 0 0 0 0 0 0 0 0 1 
1 0 0 0 0 0 0 0 0 0 0 1 
1 2 0 0 2 0 0 0 0 0 0 1 
1 0 0 0 0 0 0 0 0 0 0 1 
1 0 0 0 0 0 0 1 1 0 0 1 
1 0 0 0 0 0 0 1 0 0 0 1 
1 0 0 0 0 0 0 0 8 0 1 1 
1 0 5 0 0 0 0 0 0 1 0 1 
1 0 0 0 1 0 0 0 0 0 0 1 
1 1 1 1 1 1 1 1 1 1 1 1 

[Fuel]
24