[Textures]
Tiles\GreyBlock
Tiles\BlueBlock
Tiles\RedBlock

[Layout]
1 1 1 1 1 1 1 1 1 1 1 1 
1 0 0 0 0 0 1 0 0 0 0 1 
1 0 0 0 0 0 1 0 0 0 0 1 
1 0 0 0 0 0 0 0 0 0 0 1 
1 0 2 0 9 0 8 0 2 0 0 1 
1 0 0 0 0 0 0 0 0 0 0 1 
1 0 0 0 0 0 0 0 0 0 0 1 
1 1 0 0 0 0 0 0 5 0 0 1 
1 0 0 0 2 0 0 0 1 1 0 1 
1 0 0 0 0 0 0 0 0 0 0 1 
1 0 5 0 0 0 2 0 0 0 0 1 
1 0 0 0 0 0 0 0 0 0 0 1 
1 1 0 0 0 1 0 0 0 0 0 1 
1 1 1 0 1 0 0 2 0 0 0 1 
1 0 0 0 0 0 0 0 0 0 1 1 
1 0 0 0 0 2 0 0 0 0 1 1 
1 0 0 0 0 0 0 0 0 0 0 1 
1 1 1 1 1 1 1 1 1 1 1 1 

[Fuel]
12