[Textures]
Tiles\GreyBlock
Tiles\BlueBlock
Tiles\RedBlock

[Layout]
1 1 1 1 1 1 1 1 1 1 1 1 
1 5 5 1 4 4 4 4 1 0 1 1 
1 0 0 0 0 0 0 0 1 4 0 1 
1 0 0 8 0 0 0 0 0 0 0 1 
1 0 0 0 0 0 0 0 0 0 2 1 
1 0 0 0 1 0 0 0 0 0 0 1 
1 0 0 0 0 0 0 0 0 1 0 1 
1 1 0 0 0 0 0 0 0 0 0 1 
1 4 0 0 0 0 3 0 0 0 0 1 
1 0 0 0 0 0 0 0 0 0 0 1 
1 0 0 0 0 3 0 0 0 0 1 1 
1 1 0 1 0 0 0 1 0 0 1 1 
1 0 0 0 0 0 0 0 0 2 5 1 
1 0 0 0 0 1 0 0 0 0 0 1 
1 0 0 0 0 0 0 0 0 0 0 1 
1 0 0 3 0 0 0 0 0 0 0 1 
1 1 1 0 4 5 4 0 9 1 0 1 
1 1 1 1 1 1 1 1 1 1 1 1 

[Fuel]
49