[Textures]
Tiles\GreyBlock
Tiles\BlueBlock
Tiles\RedBlock

[Layout]
1 1 1 1 1 1 1 1 1 1 1 1 
1 0 0 0 0 3 0 0 0 5 5 1 
1 5 0 0 0 0 0 0 0 0 0 1 
1 0 0 0 0 2 0 0 0 0 0 1 
1 0 0 0 0 0 0 0 0 0 0 1 
1 0 0 0 0 0 0 0 0 0 0 1 
1 0 0 0 0 0 0 0 1 0 0 1 
1 0 0 0 2 9 0 0 0 3 0 1 
1 0 2 0 0 0 2 0 8 0 0 1 
1 0 0 0 1 0 1 0 0 0 0 1 
1 4 1 0 0 0 0 0 0 0 0 1 
1 0 0 0 1 0 0 0 0 0 0 1 
1 1 0 0 0 0 0 0 0 0 0 1 
1 0 0 0 0 0 0 0 0 3 0 1 
1 0 0 0 0 0 0 0 0 0 0 1 
1 0 0 0 0 0 0 0 0 0 0 1 
1 0 0 0 4 0 0 0 0 4 1 1 
1 1 1 1 1 1 1 1 1 1 1 1

[Fuel]
30