[Textures]
Tiles\GreyBlock
Tiles\BlueBlock
Tiles\RedBlock

[Layout]
1 1 1 1 1 1 1 1 1 1 1 1 
1 0 0 0 0 0 1 0 0 1 0 1 
1 3 0 0 0 0 0 0 0 0 8 1 
1 0 0 0 0 0 4 2 0 0 1 1 
1 0 0 0 0 0 0 0 0 0 0 1 
1 1 0 0 0 0 0 1 0 0 0 1 
1 0 0 0 0 0 0 0 0 1 1 1 
1 0 0 0 0 0 5 0 0 0 0 1 
1 1 1 0 0 0 0 0 0 0 0 1 
1 0 0 0 0 0 0 0 3 0 0 1 
1 0 0 0 0 0 0 0 0 0 1 1 
1 0 0 2 0 0 4 0 0 0 0 1 
1 1 0 0 0 0 0 0 0 0 0 1 
1 0 0 0 0 0 0 0 0 0 0 1 
1 0 0 0 0 0 0 0 0 0 1 1 
1 0 0 0 0 0 5 0 0 0 0 1 
1 0 0 0 0 0 0 0 0 0 9 1 
1 1 1 1 1 1 1 1 1 1 1 1 

[Fuel]
20