[Textures]
Tiles\GreyBlock
Tiles\BlueBlock
Tiles\RedBlock

[Layout]
1 1 1 1 1 1 1 1 1 1 1 1 
1 0 0 2 0 0 0 0 0 1 1 1 
1 0 0 2 0 0 3 0 0 0 0 1 
1 0 0 2 0 0 4 0 0 0 0 1 
1 0 0 0 0 2 0 0 0 0 0 1 
1 1 4 0 0 0 0 4 0 0 0 1 
1 0 0 0 3 0 0 0 0 0 0 1 
1 0 0 0 0 0 0 8 3 0 0 1 
1 3 0 0 0 3 9 0 3 0 0 1 
1 0 0 0 0 0 0 0 0 0 0 1 
1 0 0 0 1 0 0 0 1 0 0 1 
1 0 0 0 0 0 0 0 0 0 0 1 
1 2 2 0 0 0 4 0 0 0 0 1 
1 1 1 0 0 0 0 0 0 0 0 1 
1 0 0 0 0 0 0 0 0 0 0 1 
1 0 0 0 0 0 0 0 0 1 0 1 
1 0 0 0 1 1 0 0 0 0 0 1 
1 1 1 1 1 1 1 1 1 1 1 1 

[Fuel]
18