[Textures]
Tiles\GreyBlock
Tiles\BlueBlock
Tiles\RedBlock

[Layout]
1 1 1 1 1 1 1 1 1 1 1 1 
1 2 0 0 0 4 1 0 0 0 0 1 
1 0 3 3 2 5 1 0 0 2 0 1 
1 0 0 0 0 4 3 0 2 0 0 1 
1 1 2 0 2 5 1 3 0 0 3 1 
1 0 0 0 0 4 3 0 2 2 0 1 
1 0 3 0 2 5 1 0 0 0 0 1 
1 0 2 0 0 4 3 2 0 3 2 1 
1 0 0 3 2 5 1 0 0 0 2 1 
1 0 3 0 0 4 3 0 3 0 0 1 
1 2 0 2 2 5 1 2 0 3 0 1 
1 0 0 0 0 4 3 0 0 0 0 1 
1 1 2 3 2 5 1 0 1 0 0 1 
1 0 0 0 0 4 3 0 0 0 1 1 
1 0 0 0 0 5 3 0 0 1 0 1 
1 0 0 0 1 4 1 1 0 0 0 1 
1 3 0 0 2 9 1 0 0 8 0 1 
1 1 1 1 1 1 1 1 1 1 1 1 

[Fuel]
28