[Textures]
Tiles\GreyBlock
Tiles\BlueBlock
Tiles\RedBlock

[Layout]
1 1 1 1 1 1 1 1 1 1 1 1 
1 0 0 0 0 0 0 0 0 0 0 1 
1 0 0 1 1 1 1 1 0 0 0 1 
1 0 0 0 0 0 0 0 0 0 0 1 
1 0 0 0 0 0 0 0 4 0 0 1 
1 0 0 0 0 0 0 0 0 0 0 1 
1 0 0 0 2 2 2 0 0 0 0 1 
1 0 0 0 0 0 0 0 0 0 0 1 
1 0 0 0 0 0 0 0 0 0 0 1 
1 0 0 0 0 0 0 0 0 0 0 1 
1 0 0 0 0 0 3 0 0 0 0 1 
1 0 0 0 0 0 3 0 0 0 0 1 
1 0 0 0 0 0 3 0 0 0 0 1 
1 0 0 0 0 0 0 0 0 0 0 1 
1 0 0 0 0 0 0 0 0 0 0 1 
1 0 0 0 5 0 0 0 0 0 0 1 
1 9 0 0 0 0 0 0 0 0 0 1 
1 1 1 1 1 1 1 1 1 1 1 1 